111111111
100111C11
1P000E001
111101101
100C00101
111111111