111111111
100101C11
1P000E001
111101101
100C00101
111111111