111111111
1E0111C11
10P011111
111101101
100000101
111111111