11111111111111111111
1E000000000000000001
10000000000000000001
10000000000000000CP1
11111111111111111111
